study	n
group	n
system	n
social	j
provide	v
however	r
research	n
level	n
result	n
include	v
important	j
process	n
use	n
development	n
data	n
information	n
effect	n
change	n
table	n
policy	n
university	n
model	n
experience	n
activity	n
human	j
history	n
develop	v
suggest	v
economic	j
low	j
relationship	n
both	r
value	n
require	v
role	n
difference	n
analysis	n
practice	n
society	n
thus	r
control	n
form	n
report	v
rate	n
significant	j
figure	n
factor	n
interest	n
culture	n
need	n
base	v
population	n
international	j
technology	n
individual	n
type	n
describe	v
indicate	v
image	n
subject	n
science	n
material	n
produce	v
condition	n
identify	v
knowledge	n
support	n
performance	n
project	n
response	n
approach	n
support	v
period	n
organization	n
increase	v
environmental	j
source	n
nature	n
cultural	j
resource	n
century	n
strategy	n
theory	n
product	n
method	n
goal	n
likely	j
note	v
represent	v
general	j
article	n
similar	j
environment	n
language	n
determine	v
structure	n
section	n
common	j
occur	v
current	j
available	j
present	v
term	n
reduce	v
measure	n
involve	v
movement	n
specific	j
focus	v
region	n
relate	v
individual	j
quality	n
establish	v
author	n
seek	v
compare	v
growth	n
natural	j
various	j
standard	n
example	n
management	n
scale	n
argue	v
degree	n
design	n
concern	n
state	v
therefore	r
examine	v
pattern	n
researcher	n
task	n
traditional	j
finding	n
positive	j
central	j
act	n
impact	n
reflect	v
recognize	v
context	n
relation	n
maintain	v
African	j
concept	n
discussion	n
associate	v
design	v
particularly	r
purpose	n
address	v
define	v
particular	j
benefit	n
survey	n
effective	j
apply	v
contain	v
understanding	n
production	n
form	v
association	n
reveal	v
range	n
affect	v
attitude	n
status	n
necessary	j
function	n
indeed	r
present	j
global	j
conflict	n
achieve	v
conduct	v
critical	j
perform	v
discuss	v
exist	v
improve	v
observe	v
demonstrate	v
unit	n
total	j
modern	j
literature	n
result	v
experience	v
principle	n
element	n
challenge	n
control	v
historical	j
aspect	n
perspective	n
basic	j
measure	v
tradition	n
belief	n
western	j
procedure	n
test	v
category	n
tend	v
technique	n
outcome	n
significantly	r
generally	r
future	j
mean	n
importance	n
application	n
feature	n
influence	n
basis	n
interaction	n
refer	v
communication	n
negative	j
primary	j
characteristic	n
European	j
lack	n
obtain	v
potential	j
variety	n
component	n
following	j
access	n
contribute	v
assume	v
express	v
tool	n
promote	v
participate	v
labor	n
engage	v
review	n
additional	j
highly	r
appropriate	j
publish	v
encourage	v
successful	j
assess	v
view	v
client	n
instrument	n
relatively	r
meaning	n
limit	v
increase	n
directly	r
previous	j
demand	n
vision	n
female	j
attempt	n
influence	v
independent	j
solution	n
direct	j
conclusion	n
presence	n
scientific	j
ethnic	j
complex	j
active	j
male	n
claim	n
participation	n
focus	n
contrast	n
failure	n
internal	j
journal	n
multiple	j
facility	n
user	n
emerge	v
protection	n
extent	n
male	j
mental	j
explore	v
consequence	n
generate	v
content	n
device	n
requirement	n
broad	j
observation	n
visual	j
difficulty	n
regional	j
perceive	v
ie	r
urban	j
female	n
capacity	n
increased	j
ensure	v
select	v
moreover	r
emphasize	v
institute	n
extend	v
connection	n
sector	n
commitment	n
interpretation	n
evaluate	v
conclude	v
notion	n
increasingly	r
domestic	j
consist	v
reference	n
initial	j
adopt	v
comparison	n
depend	v
attempt	v
standard	j
predict	v
employ	v
definition	n
essential	j
contact	n
frequently	r
colleague	n
actual	j
account	v
dimension	n
theme	n
largely	r
link	v
desire	n
overall	j
useful	j
consistent	j
distribution	n
minority	n
analyze	v
range	v
psychological	j
unique	j
experiment	n
trend	n
exchange	n
percentage	n
objective	n
implication	n
contribution	n
enable	v
organize	v
specifically	r
currently	r
emotional	j
locate	v
primarily	r
scholar	n
enhance	v
improvement	n
flow	n
estimate	v
phase	n
rural	j
typically	r
above	r
long-term	j
core	n
volume	n
approximately	r
limited	j
propose	v
framework	n
existing	j
creation	n
code	n
emphasis	n
industrial	j
external	j
waste	n
potential	n
climate	n
explanation	n
technical	j
mechanism	n
description	n
vary	v
reduction	n
discipline	n
construct	v
equal	j
origin	n
rely	v
fundamental	j
transition	n
assumption	n
German	j
existence	n
formal	j
manner	n
assistance	n
combination	n
increasing	j
hypothesis	n
phenomenon	n
planning	n
error	n
household	n
cite	v
lack	v
judgment	n
constitute	v
relevant	j
typical	j
selection	n
incorporate	v
illustrate	v
cycle	n
depression	n
consideration	n
previously	r
arise	v
developing	j
separate	j
recognition	n
mode	n
similarly	r
resistance	n
furthermore	r
diversity	n
practical	j
anxiety	n
acquire	v
characterize	v
differ	v
review	v
interpret	v
creative	j
limitation	n
resolution	n
implementation	n
numerous	j
significance	n
revolution	n
philosophy	n
display	v
professional	n
publication	n
variation	n
derive	v
alternative	n
widely	r
permit	v
alternative	j
merely	r
initiative	n
employment	n
regard	v
estimate	n
effectively	r
cooperation	n
transform	v
absence	n
imply	v
comprehensive	j
observer	n
nevertheless	r
testing	n
link	n
evolution	n
intellectual	j
signal	n
passage	n
facilitate	v
discovery	n
biological	j
introduction	n
boundary	n
substantial	j
ratio	n
strongly	r
theoretical	j
gain	n
general	r
settlement	n
independence	n
yield	v
formation	n
insight	n
territory	n
conventional	j
inform	v
index	n
crucial	j
racial	j
detect	v
poverty	n
agricultural	j
distinction	n
relative	j
identification	n
shift	n
monitor	v
domain	n
integration	n
whole	n
subsequent	j
strategic	j
preference	n
profession	n
apparent	j
assign	v
joint	j
Asian	j
exception	n
dependent	j
presentation	n
proportion	n
universal	j
norm	n
tendency	n
considerable	j
respectively	r
equally	r
resolve	v
competitive	j
related	j
symbol	n
consumption	n
calculate	v
dominant	j
extensive	j
barrier	n
advanced	j
motor	n
adjustment	n
shape	v
integrate	v
dominate	v
establishment	n
entry	n
visible	j
stability	n
efficiency	n
sequence	n
hence	r
process	v
given	j
sufficient	j
dialogue	n
distinct	j
enterprise	n
transformation	n
scope	n
assert	v
capability	n
reflection	n
precisely	r
electronic	j
decline	n
distinguish	v
retain	v
expansion	n
evolve	v
incentive	n
survival	n
recommendation	n
structural	j
possess	v
encounter	v
membership	n
rapidly	r
adapt	v
utility	n
initially	r
intention	n
rapid	j
collective	j
reinforce	v
ethical	j
exhibit	v
ongoing	j
function	v
communicate	v
valuable	j
detailed	j
potentially	r
wealth	n
trait	n
administrative	j
initiate	v
adequate	j
ideal	j
instance	n
alter	v
indicator	n
strengthen	v
statistics	n
thereby	r
accurate	j
assembly	n
acceptance	n
stress	v
stable	j
guideline	n
justify	v
profile	n
statistical	j
attribute	v
scenario	n
document	v
exclude	v
advance	v
regardless	r
sustain	v
consensus	n
mutual	j
radical	j
commonly	r
virtue	n
equation	n
evident	j
processing	n
dynamics	n
vessel	n
efficient	j
practitioner	n
highlight	v
successfully	r
intensity	n
complexity	n
input	n
mainly	r
functional	j
consequently	r
agriculture	n
distribute	v
myth	n
scheme	n
ethics	n
vital	j
exceed	v
summary	n
manufacturing	n
format	n
technological	j
convert	v
database	n
innovation	n
obligation	n
demographic	j
inquiry	n
output	n
etc	r
bias	n
extension	n
empirical	j
guide	v
widespread	j
prominent	j
nonetheless	r
logic	n
maintenance	n
principal	j
helpful	j
simultaneously	r
constraint	n
dynamic	j
circuit	n
ritual	n
economics	n
proposed	j
workshop	n
changing	j
undertake	v
discrimination	n
greatly	r
graph	n
restriction	n
motivate	v
compose	v
autonomy	n
frequent	j
aim	n
accuracy	n
acceptable	j
maximum	j
restrict	v
conception	n
comprise	v
heritage	n
consistently	r
province	n
migration	n
minimize	v
spectrum	n
entity	n
modify	v
realm	n
absolute	j
array	n
shared	j
counterpart	n
interact	v
render	v
separation	n
concern	v
abstract	j
foster	v
exploration	n
parameter	n
continuous	j
well-being	n
colony	n
undermine	v
uncertainty	n
superior	j
civilization	n
conceptual	j
transmission	n
paradigm	n
diagram	n
classify	v
expertise	n
inventory	n
continued	j
occupation	n
prediction	n
improved	j
everyday	j
underlying	j
access	v
encounter	n
spatial	j
adoption	n
readily	r
quantity	n
productivity	n
integrated	j
explicitly	r
ownership	n
net	j
sensitivity	n
prior	j
reliable	j
compliance	n
availability	n
systematic	j
historically	r
probability	n
traditionally	r
advocate	v
informal	j
aggression	n
acquisition	n
critique	n
likelihood	n
similarity	n
inherent	j
actively	r
govern	v
ethnicity	n
integrity	n
emerging	j
selected	j
specify	v
likewise	r
correspond	v
sphere	n
stimulus	n
linear	j
infrastructure	n
model	v
inclusion	n
explicit	j
socially	r
forum	n
research	v
convey	v
weakness	n
virtual	j
necessity	n
hierarchy	n
obstacle	n
import	n
equality	n
productive	j
dilemma	n
progressive	j
conversion	n
socioeconomic	j
classification	n
label	v
articulate	v
continuing	j
random	j
transaction	n
profound	j
required	j
ideal	n
rational	j
summarize	v
value	v
attribute	n
identical	j
subsequently	r
objective	j
sum	n
isolation	n
consistency	n
sustainable	j
representative	j
positively	r
survey	v
calculation	n
overall	r
comparable	j
revolutionary	j
minimal	j
isolate	v
willingness	n
flexibility	n
imagery	n
promotion	n
residential	j
developed	j
short	r
adaptation	n
recipient	n
neutral	j
monitoring	n
beneficial	j
exclusively	r
precise	j
substantially	r
flexible	j
conceive	v
problematic	j
persist	v
valid	j
embody	v
stimulate	v
modification	n
artifact	n
subjective	j
extended	j
diminish	v
expected	j
combined	j
attain	v
comparative	j
partial	j
fixed	j
matrix	n
innovative	j
influential	j
voluntary	j
induce	v
expenditure	n
stem	v
accurately	r
monetary	j
patent	n
emergence	n
outline	v
appreciation	n
rejection	n
favorable	j
known	j
morality	n
namely	r
philosopher	n
experienced	j
manipulate	v
tolerance	n
solely	r
resulting	j
modem	n
census	n
vertical	j
accordingly	r
preliminary	j
commodity	n
temporal	j
short-term	j
distinctive	j
logical	j
globalization	n
premise	n
exploit	v
inadequate	j
desirable	j
dependence	n
clarify	v
considerably	r
geographic	j
reside	v
specialized	j
excessive	j
transport	n
theorist	n
formulate	v
equivalent	j
deem	v
aid	v
partially	r
manipulation	n
independently	r
manifest	v
frontier	n
accessible	j
correctly	r
inability	n
respective	j
fragment	n
originate	v
suitable	j
economically	r
integral	j
assertion	n
established	j
exclusion	n
axis	n
projection	n
governmental	j
aspiration	n
stance	n
entail	v
transmit	v
encompass	v
governance	n
notably	r
recruitment	n
rationale	n
novel	j
configuration	n
manual	n
center	v
intensive	j
minimum	n
applied	j
cue	n
regard	n
supportive	j
attachment	n
indirect	j
interactive	j
invoke	v
differentiate	v
optimal	j
viable	j
reproduce	v
coordinate	v
revision	n
passive	j
advocacy	n
above	j
isolated	j
dual	j
justification	n
disposal	n
modeling	n
thesis	n
vendor	n
occurrence	n
prospective	j
authentic	j
relevance	n
inevitably	r
marginal	j
municipal	j
designate	v
correspondence	n
maximize	v
implicit	j
devise	v
scholarly	j
erosion	n
striking	j
stereotype	n
contradiction	n
invention	n
fraction	n
strive	v
skilled	j
importantly	r
manifestation	n
disturbance	n
varying	j
continuity	n
commentary	n
corresponding	j
large-scale	j
reproduction	n
analogy	n
adequately	r
restoration	n
couple	v
negatively	r
reconstruction	n
desired	j
inequality	n
contrast	v
preferred	j
export	v
within	r
societal	j
usage	n
persistent	j
orient	v
repeated	j
accumulate	v
allocation	n
compensate	v
coordination	n
sufficiently	r
formulation	n
ironically	r
progress	v
separately	r
policymaker	n
operational	j
horizontal	j
marital	j
revise	v
align	v
psychiatric	j
parallel	j
reduced	j
purely	r
reproductive	j
prejudice	n
notable	j
exert	v
inhabitant	n
absent	j
dominance	n
hostility	n
embed	v
extract	v
subject	v
individually	r
competing	j
normative	j
suppress	v
endeavor	n
contrary	n
disagreement	n
advisory	j
mediate	v
neglect	v
fundamentally	r
reported	j
territorial	j
precision	n
ambiguity	n
farming	n
preservation	n
lesser	j
applicable	j
cultivate	v
situate	v
precede	v
static	j
differential	j
continually	r
vulnerability	n
selective	j
pathway	n
autonomous	j
confine	v
undoubtedly	r
predominantly	r
fulfill	v
proponent	n
hemisphere	n
elicit	v
hypothesize	v
trajectory	n
underlie	v
analytical	j
replicate	v
parallel	n
improving	j
synthesis	n
fertility	n
adaptive	j
underscore	v
causal	j
allocate	v
realization	n
paragraph	n
beta	n
overview	n
composite	j
privatization	n
characteristic	j
hierarchical	j
linkage	n
constrain	v
mobilize	v
disposition	n
broadly	r
viewpoint	n
import	v
harmful	j
applicant	n
insufficient	j
modified	j
thinker	n
documentation	n
successor	n
provincial	j
proliferation	n
reliance	n
formally	r
academic	n
categorize	v
exploitation	n
collaborate	v
abundant	j
varied	j
interference	n
variable	j
verify	v
instability	n
conform	v
map	v
ground	v
advancement	n
validate	v
destructive	j
recreational	j
warrant	v
disadvantage	n
term	v
coherent	j
intermediate	j
empower	v
prevalent	j
sustained	j
aging	n
compatible	j
monopoly	n
ambiguous	j
interdisciplinary	j
disparity	n
prevailing	j
disruption	n
radically	r
uniform	j
generator	n
appropriate	v
generic	j
accepted	j
domination	n
degradation	n
leisure	n
interestingly	r
maternal	j
complicate	v
systematically	r
primitive	j
conversely	r
transcend	v
published	j
coincide	v
educated	j
fulfil	v
advisor	n
dependency	n
structured	j
supplement	v
locally	r
enhanced	j
sustainability	n
structure	v
descendant	n
pervasive	j
expanding	j
gradual	j
appropriately	r
conflicting	j
exemplify	v
appropriation	n
activate	v
directive	n
incomplete	j
locus	n
exacerbate	v
proximity	n
bureaucratic	j
indirectly	r
refine	v
efficiently	r
inconsistent	j
mutually	r
refusal	n
substitute	n
offspring	n
long-standing	j
apparatus	n
thorough	j
robust	j
informed	j
plausible	j
workforce	n
maturity	n
mediation	n
livestock	n
expectancy	n
continuously	r
inhabit	v
adhere	v
intensify	v
continuum	n
elaborate	v
focal	j
paradox	n
distortion	n
qualification	n
prestige	n
critically	r
contradictory	j
alignment	n
decision-making	j
migrate	v
petroleum	n
arbitrary	j
rigorous	j
feasible	j
specification	n
preclude	v
constituency	n
traumatic	j
guiding	j
inferior	j
expanded	j
multiply	v
empathy	n
extensively	r
salient	j
enlightenment	n
openness	n
subgroup	n
Greek	n
compound	v
inclusive	j
reconcile	v
decision-making	n
straightforward	j
posit	v
privileged	j
cumulative	j
effect	v
pragmatic	j
complementary	j
susceptible	j
remainder	n
succession	n
dissatisfaction	n
decisive	j
utilization	n
spontaneous	j
enhancement	n
radical	n
superiority	n
marked	j
periodic	j
southeastern	j
contention	n
whereby	r
participating	j
accord	v
elimination	n
preceding	j
hybrid	j
thereafter	r
methodological	j
discern	v
accumulation	n
profoundly	r
collectively	r
span	v
variant	n
competitiveness	n
discrete	j
inherently	r
disciplinary	j
wholly	r
enduring	j
displace	v
probe	v
broaden	v
relational	j
revised	j
perpetuate	v
complement	v
restructuring	n
reconstruct	v
arguably	r
successive	j
definitive	j
adulthood	n
procedural	j
empowerment	n
resonance	n
inference	n
contradict	v
unstable	j
hypothetical	j
multimedia	n
appendix	n
infer	v
distort	v
manual	j
enrich	v
differentiation	n
reformer	n
confer	v
simultaneous	j
high-quality	j
scarce	j
reversal	n
activism	n
alleviate	v
constructive	j
differing	j
imperative	n
industrialized	j
sociology	n
infinite	j
group	v
theoretically	r
ineffective	j
probable	j
consolidate	v
adjacent	j
unrelated	j
unified	j
acknowledgment	n
discriminate	v
denote	v
hinder	v
friction	n
culminate	v
default	n
equilibrium	n
mandate	v
determinant	n
advent	n
implicitly	r
terminology	n
imbalance	n
ideally	r
tangible	j
diffusion	n
timely	j
mitigate	v
municipality	n
restrictive	j
comprehend	v
evidence	v
erode	v
projected	j
in-depth	j
contingency	n
declining	j
numerical	j
interpretive	j
cultivation	n
eventual	j
incur	v
redefine	v
cohesion	n
benchmark	n
sound	j
fusion	n
analogous	j
ethic	n
coercion	n
submission	n
ascertain	v
presently	r
authoritative	j
equate	v
moderate	v
reviewer	n
myriad	n
printed	j
satisfactory	j
printing	n
alteration	n
adult	j
finite	j
periodically	r
footnote	n
holistic	j
moderately	r
endowment	n
scarcity	n
mapping	n
quantify	v
segregation	n
usefulness	n
insistence	n
consciously	r
consolidation	n
collaborator	n
incorporation	n
engender	v
specificity	n
transitional	j
familiarity	n
contour	n
validation	n
proportional	j
navigation	n
allowance	n
outreach	n
citation	n
institute	v
impede	v
outset	n
reciprocal	j
designation	n
rightly	r
disperse	v
shortcoming	n
unsuccessful	j
alternatively	r
transparency	n
inheritance	n
convergence	n
catalyst	n
subordinate	j
decay	n
conserve	v
handbook	n
situational	j
intentional	j
generalized	j
consortium	n
facet	n
implicate	v
working	n
homogeneous	j
resilience	n
centralized	j
preoccupation	n
multinational	j
internally	r
rationality	n
uniquely	r
parallel	v
assimilate	v
enlarge	v
nongovernmental	j
perpetrator	n
delineate	v
disseminate	v
necessitate	v
mediator	n
trained	j
internalize	v
multiple	n
fragmentation	n
tailor	v
factual	j
indicative	j
lessen	v
heightened	j
precursor	n
overlap	n
augment	v
estimation	n
Dominican	j
sociological	j
portrayal	n
deprivation	n
trade-off	n
sanction	v
overt	j
intuitive	j
pertinent	j
reprint	v
specified	j
prominence	n
deterioration	n
commercially	r
richness	n
face-to-face	j
jointly	r
inclination	n
bridge	v
individualism	n
noteworthy	j
impetus	n
experimentation	n
sequential	j
continuation	n
attributable	j
disparate	j
safeguard	v
suppression	n
subset	n
markedly	r
concurrent	j
degrade	v
incompatible	j
tenet	n
unify	v
attest	v
indispensable	j
intended	j
simplify	v
periphery	n
analytic	j
nominal	j
divergent	j
present-day	j
substitution	n
novelty	n
coherence	n
unpublished	j
template	n
sociologist	n
containment	n
encode	v
socialize	v
determining	j
interdependence	n
universally	r
directory	n
restructure	v
coordinate	n
limiting	j
extraction	n
affinity	n
prescribed	j
locality	n
induction	n
concur	v
familial	j
eruption	n
imperative	j
generating	j
computerized	j
latent	j
restricted	j
synthesize	v
heighten	v
customary	j
insecurity	n
equitable	j
specialization	n
vitality	n
centrality	n
incremental	j
on-site	j
termination	n
explanatory	j
anticipated	j
by-product	n
emanate	v
breadth	n
propensity	n
dichotomy	n
unequal	j
cost-effective	j
multitude	n
irregular	j
construe	v
conformity	n
accessibility	n
ascribe	v
stringent	j
marginalize	v
epistemological	j
contest	v
noticeable	j
reiterate	v
reaffirm	v
fragmented	j
inconsistency	n
conflict	v
drawback	n
viability	n
chosen	j
contingent	j
neural	j
persuasive	j
verification	n
ostensibly	r
detrimental	j
undesirable	j
multidimensional	j
heterogeneous	j
participatory	j
self-interest	n
replication	n
unrealistic	j
networking	n
high-level	j
precipitate	v
sharing	n
refrain	v
continual	j
primacy	n
globally	r
institutionalize	v
conducive	j
capitalist	n
dissemination	n
coexist	v
suffice	v
feasibility	n
theorize	v
identifiable	j
principally	r
commonplace	j
amplify	v
outweigh	v
comparatively	r
composite	n
inefficient	j
imagined	j
intellect	n
coercive	j
altered	j
speculative	j
infuse	v
reference	v
persuasion	n
abandonment	n
objectivity	n
postulate	v
endow	v
coordinated	j
progressively	r
motivated	j
intrusion	n
interplay	n
aggregate	j
livelihood	n
ethos	n
conspicuous	j
espouse	v
proxy	n
disregard	v
stimulating	j
convert	n
emergent	j
connected	j
partition	n
sociopolitical	j
observable	j
transient	j
two-way	j
measurable	j
insignificant	j
interruption	n
inception	n
legitimize	v
predominant	j
binding	j
admittedly	r
pertain	v
paramount	j
confound	v
uniqueness	n
collective	n
bipolar	j
favorably	r
following	r
measured	j
hamper	v
founding	n
learned	j
real-world	j
undertaking	n
underline	v
one-way	j
pioneering	j
manifest	j
disproportionate	j
anecdotal	j
scientifically	r
eradicate	v
emulate	v
approximate	v
manufacture	n
overlapping	j
refinement	n
geometric	j
positioning	n
inadequacy	n
workload	n
stated	j
decreasing	j
reciprocity	n
stationary	j
remedy	v
urbanization	n
merit	v
geographically	r
lecturer	n
innate	j
responsiveness	n
targeted	j
accelerated	j
completed	j
elaboration	n
subtract	v
intrinsically	r
permeate	v
dissolution	n
ancestry	n
prominently	r
fruitful	j
integrative	j
logically	r
receptive	j
small-scale	j
prophecy	n
polarization	n
omission	n
supplemental	j
locale	n
clarification	n
imperfect	j
micro	n
further	v
ensuing	j
impart	v
impediment	n
purchasing	n
Anglo	j
rigor	n
unintended	j
wherein	r
informative	j
localized	j
endemic	j
unresolved	j
relegate	v
enlightened	j
compatibility	n
instructive	j
incidental	j
contrasting	j
intolerance	n
penetration	n
intimately	r
concentrated	j
suggestive	j
spontaneously	r
stratum	n
vignette	n
bonding	n
biomedical	j
usable	j
neutrality	n
egalitarian	j
chiefly	r
academia	n
extant	j
dissatisfied	j
resultant	j
differential	n
interrelated	j
professionalism	n
reorganization	n
invaluable	j
contributing	j
compulsory	j
affiliate	v
presuppose	v
fabricate	v
standardize	v
repetitive	j
seminal	j
embedded	j
simulated	j
far-reaching	j
aforementioned	j
concomitant	j
diffuse	j
reliably	r
uniformly	r
deplete	v
divergence	n
stipulate	v
biased	j
provisional	j
preferential	j
negligible	j
oppressed	j
ramification	n
intermediary	n
condition	v
ethnically	r
sequencing	n
attractiveness	n
adherent	n
unfavorable	j
typology	n
propagate	v
in-house	j
heterogeneity	n
preferable	j
decentralized	j
transcription	n
diffuse	v
multidisciplinary	j
interdependent	j
diversification	n
third-party	j
consequent	j
accrue	v
parity	n
asymmetry	n
attitudinal	j
adversely	r
re-establish	v
literate	j
expend	v
time-consuming	j
subculture	n
neutralize	v
refute	v
relocation	n
simplistic	j
categorization	n
resurgence	n
strategically	r
conditional	j
disintegration	n
lag	n
naturalist	n
redistribution	n
selectively	r
concerted	j
electronically	r
infancy	n
recourse	n
modernize	v
citizenry	n
approximation	n
multiplicity	n
re-examine	v
standardization	n
ally	v
objectively	r
homogeneity	n
intersect	v
stewardship	n
pervade	v
parochial	j
attendee	n
strikingly	r
suggested	j
arid	j
null	j
prerogative	n
conceptually	r
cadre	n
evolving	j
cooperative	n
anatomical	j
staffing	n
focused	j
misuse	n
ordering	n
monograph	n
lastly	r
corrective	j
cortex	n
complement	n
counterproductive	j
predispose	v
synonymous	j
separated	j
individualistic	j
expulsion	n
assertive	j
applicability	n
immersion	n
repository	n
intrusive	j
purport	v
powerfully	r
consent	v
primer	n
guise	n
biologically	r
disproportionately	r
externally	r
idealism	n
bias	v
taboo	n
triad	n
commonality	n
deficient	j
corroborate	v
pathological	j
minimally	r
negate	v
conjunction	n
erroneous	j
English-speaking	j
uniformity	n
verbally	r
westerner	n
regularity	n
regeneration	n
elective	j
precondition	n
inequity	n
reorganize	v
retrieval	n
accentuate	v
predicate	v
prenatal	j
recognized	j
predominate	v
populace	n
archival	j
counteract	v
dominion	n
advantageous	j
informational	j
congruent	j
diverge	v
dispersion	n
cohesive	j
redirect	v
self-image	n
tenuous	j
decision-maker	n
vertically	r
subordinate	n
eminent	j
intertwine	v
oppositional	j
virtuous	j
weight	v
substantiate	v
enlargement	n
coerce	v
concluding	j
threatened	j
compensatory	j
prioritize	v
technologically	r
transformative	j
topography	n
wording	n
periodical	n
antecedent	n
unwillingness	n
elucidate	v
intervening	j
impersonal	j
marginally	r
pre-existing	j
eschew	v
defined	j
circumvent	v
fluctuate	v
normalize	v
supplant	v
dislocation	n
caveat	n
outward	j
precept	n
cyclical	j
unavoidable	j
auspice	n
supervisory	j
well-established	j
aggregate	n
rationalize	v
harmonious	j
variously	r
requisite	j
overestimate	v
ideologically	r
maturation	n
proliferate	v
manufactured	j
benevolent	j
calibrate	v
deviate	v
idiosyncratic	j
institutionalized	j
utilitarian	j
insightful	j
colonize	v
accumulated	j
antagonism	n
predetermined	j
recur	v
thereof	r
endeavor	v
dependent	n
supplementary	j
institutionalization	n
inverse	j
irreversible	j
corollary	n
enumerate	v
centrally	r
ecologically	r
underpin	v
linked	j
preparatory	j
conduit	n
precedence	n
exhaustive	j
decentralization	n
deduce	v
approximate	j
inseparable	j
increment	n
rudimentary	j
overarching	j
expressed	j
paternal	j
well-defined	j
functionally	r
fostering	n
material	j
potency	n
unitary	j
concurrently	r
top-down	j
budgetary	j
presumed	j
additive	j
inactive	j
interrelationship	n
creatively	r
marginalized	j
judgement	n
inefficiency	n
transmitted	j
imbue	v
aggregation	n
calculated	j
calculus	n
excessively	r
schematic	j
aversion	n
nexus	n
attendant	j
nascent	j
universality	n
inertia	n
extrapolate	v
aberration	n
acquired	j
compulsion	n
coded	j
undue	j
unifying	j
simplified	j
indistinguishable	j
helplessness	n
duality	n
coalesce	v
inherited	j
underpinning	n
unimportant	j
tacit	j
MP	n
index	v
discontinuity	n
entrench	v
envisage	v
repress	v
redundant	j
supersede	v
distinguishing	j
computer-based	j
overriding	j
inaccessible	j
congruence	n
gratification	n
qualitatively	r
typify	v
therein	r
phenomenological	j
predisposition	n
horizontally	r
author	v
directional	j
paucity	n
mores	n
rupture	n
intractable	j
consensual	j
quarterly	n
multifaceted	j
informally	r
entrenched	j
inextricably	r
underly	v
workable	j
replete	j
devalue	v
attune	v
auxiliary	j
imperfection	n
plethora	n
prism	n
westward	r
stagnation	n
procure	v
allot	v
archaic	j
compilation	n
characteristically	r
equivalence	n
decode	v
condense	v
unskilled	j
monolithic	j
diminishing	j
foregoing	j
diminished	j
deleterious	j
organizing	j
symmetrical	j
structurally	r
neoclassical	j
herein	r
illustrative	j
causation	n
stratification	n
spatially	r
conventionally	r
assisted	j
consolidated	j
personalized	j
paraphrase	v
received	j
heuristic	j
distributed	j
discernible	j
self-sufficiency	n
stereotyping	n
abstract	v
hereditary	j
habitual	j
humanistic	j
re-evaluate	v
prior	r
predate	v
unaffected	j
esoteric	j
post-traumatic	j
oriented	j
actuality	n
documented	j
dearth	n
uncontrolled	j
commercialization	n
aggregate	v
anomalous	j
ethically	r
hitherto	r
innumerable	j
valued	j
matching	n
apex	n
duplication	n
encapsulate	v
doubling	n
broad-based	j
harmonize	v
ministerial	j
inward	j
infrequently	r
innovator	n
convergent	j
Darwinian	j
predictability	n
inverted	j
impractical	j
altruistic	j
parenthesis	n
strengthening	n
unambiguous	j
intuitively	r
reasoned	j
purify	v
aggressor	n
self-evident	j
vested	j
traditionalist	n
rigidity	n
unanticipated	j
unrestricted	j
detriment	n
eradication	n
circumscribe	v
amenable	j
empowering	j
instantaneous	j
fore	n
deconstruct	v
dissimilar	j
network	v
unquestionably	r
labeled	j
legitimately	r
ameliorate	v
antagonistic	j
hereafter	r
puzzling	j
preponderance	n
generality	n
commensurate	j
dynamism	n
sustenance	n
disengagement	n
rationally	r
indefinite	j
subordinate	v
prompt	j
contiguous	j
centralization	n
collected	j
midpoint	n
mistrust	n
intangible	j
inconclusive	j
dispersed	j
fallacy	n
consultative	j
justified	j
unsatisfactory	j
infrequent	j
expert	j
grounding	n
definitively	r
contrary	j
succeeding	j
superimpose	v
redundancy	n
accelerating	j
domesticated	j
interconnection	n
prescriptive	j
mainstream	n
italics	n
modulate	v
flourishing	j
encroachment	n
affluence	n
childbearing	j
presenter	n
rigorously	r
recast	v
inversely	r
intensification	n
rationalization	n
polarity	n
cognitively	r
underdeveloped	j
articulated	j
preserving	j
opportunistic	j
centralize	v
correspondingly	r
inflationary	j
long-lasting	j
mediating	j
labor-intensive	j
hopelessness	n
purification	n
environmentalism	n
reconfigure	v
entanglement	n
graphically	r
revitalization	n
oblique	j
cardinal	j
assumed	j
nuanced	j
conjecture	n
shaping	j
unequivocally	r
buffer	v
descending	j
persistently	r
dictate	n
achievable	j
succinctly	r
redress	v
equal	n
non-white	n
longer-term	j
self-awareness	n
suitability	n
progressive	n
popularly	r
rectify	v
redistribute	v
distinctively	r
drafting	n
credence	n
clustering	n
arbitrarily	r
exponentially	r
passively	r
symbiotic	j
concise	j
feudal	j
query	v
unbiased	j
respectability	n
shaping	n
justifiable	j
quadrant	n
predominance	n
cross-section	n
detract	v
conspicuously	r
formalize	v
undifferentiated	j
redefinition	n
interacting	j
analogue	n
sponsored	j
amorphous	j
exclusionary	j
co-author	v
mismatch	n
synergy	n
regress	v
self-serving	j
customized	j
itinerant	j
counterbalance	v
subdivide	v
ancillary	j
crystallize	v
exponential	n
unrecognized	j
explicate	v
absent	v
discord	n
materially	r
regenerate	v
allowable	j
acquiesce	v
two-fold	j
ascendancy	n
asymmetrical	j
critique	v
framing	n
functioning	j
partition	v
constructed	j
fluid	j
ever-increasing	j
self-reliance	n
meridian	n
mosaic	j
corrosive	j
denigrate	v
defensible	j
objectionable	j
reciprocate	v
globalized	j
twofold	r
singularity	n
recitation	n
progeny	n
pernicious	j
intensively	r
synonym	n
vernacular	n
unequivocal	j
incipient	j
inculcate	v
fragment	v
attenuate	v
buttress	v
disinterested	j
reclamation	n
networked	j
acquiescence	n
unsustainable	j
well-developed	j
instigate	v
powerlessness	n
dictum	n
directed	j
familiarize	v
input	v
untrained	j
unwarranted	j
impel	v
outreach	v
monopolize	v
peculiarity	n
burdensome	j
disillusionment	n
incompatibility	n
unchanging	j
nominally	r
permanence	n
illiteracy	n
indoctrination	n
ten-year	j
stipulation	n
re-evaluation	n
meaningfully	r
well-documented	j
sequentially	r
impinge	v
circular	n
concentric	j
attainable	j
bottleneck	n
miscellaneous	j
purported	j
outgrowth	n
satisfactorily	r
panacea	n
misperception	n
indiscriminate	j
extraneous	j
fluctuating	j
evolved	j
axiom	n
affiliated	j
sender	n
impurity	n
invalid	j
centrifugal	j
forebear	n
cursory	j
interweave	v
perpetuation	n
reconstitute	v
value-added	j
usurp	v
empathetic	j
quantitatively	r
granting	n
henceforth	r
conqueror	n
annal	n
landed	j
preexist	v
metrics	n
eroding	j
reversible	j
spurious	j
sup	v
unproductive	j
equivocal	j
abundantly	r
numerically	r
misrepresentation	n
inducement	n
permissive	j
normality	n
derivation	n
directorate	n
unsuitable	j
unchallenged	j
selectivity	n
heretofore	r
homogenous	j
purportedly	r
simplification	n
second-generation	j
weakening	j
demography	n
divine	v
retard	v
regionally	r
justly	r
inflexible	j
intensified	j
purview	n
judicious	j
endogenous	j
sequence	v
unexplored	j
unambiguously	r
tabulate	v
innermost	j
one-dimensional	j
predilection	n
microcomputer	n
inadequately	r
adjudicate	v
supposition	n
weighting	n
superfluous	j
expound	v
criminality	n
amply	r
apolitical	j
crucially	r
ordered	j
occasion	v
proximate	j
irrigate	v
exigency	n
zero-sum	j
upper-class	j
offence	n
harvesting	n
separating	j
elapse	v
liberated	j
perplexing	j
opine	v
nomenclature	n
nationalization	n
neuroscientist	n
multiplier	n
untenable	j
word	v
splitting	n
demarcation	n
degraded	j
consequential	j
antipathy	n
dissociation	n
inaccuracy	n
reintegration	n
superficially	r
subsidiary	j
subjectively	r
proportionate	j
re-examination	n
illuminating	j
invisibility	n
deep-seated	j
equalize	v
well-designed	j
associative	j
above-mentioned	j
imposed	j
reforming	j
usefully	r
archive	v
biochemistry	n
communicating	j
innovate	v
interconnected	j
motivating	j
peculiarly	r
constituted	j
extrapolation	n
enforced	j
demarcate	v
obviate	v
hindrance	n
sine	n
uncritical	j
unfolding	n
overemphasize	v
merging	n
deprived	j
comprehensively	r
sizeable	j
salutary	j
unquestioned	j
debatable	j
distinguishable	j
implausible	j
counterintuitive	j
transitory	j
exploitative	j
catalogue	v
conclusively	r
proclivity	n
readable	j
iterative	j
aegis	n
distributive	j
inalienable	j
laissez-faire	n
preeminence	n
switching	n
summation	n
reassessment	n
proportionately	r
progenitor	n
interconnect	v
individualist	n
outmoded	j
parlance	n
analytically	r
stricture	n
tacitly	r
vicarious	j
discriminating	j
undervalue	v
state-sponsored	j
interventionist	j
heredity	n
mitigating	j
manifestly	r
delineation	n
abbreviation	n
compendium	n
state-level	j
subpopulation	n
verifiable	j
justifiably	r
insufficiently	r
preconception	n
polarized	j
derivative	j
forego	v
veracity	n
reformulate	v
coordinating	j
bracket	v
paternalistic	j
paternalism	n
prohibitive	j
reinterpretation	n
unpredictability	n
vitally	r
immutable	j
deletion	n
declarative	j
erroneously	r
comparability	n
stagnate	v
consonant	j
avail	v
dissociate	v
academician	n
professionalization	n
quantifiable	j
deviance	n
employed	j
disincentive	n
agreed-upon	j
piecemeal	j
tuning	n
transformed	j
oversimplify	v
productively	r
identifier	n
interchangeably	r
symbiosis	n
submissive	j
verbatim	r
quarterly	r
persuasively	r
advisable	j
obsolescence	n
inclusiveness	n
dynamically	r
delimit	v
appreciable	j
psychoanalyst	n
monogamous	j
diminution	n
formalized	j
servitude	n
constructively	r
misinterpretation	n
malleable	j
minimization	n
portability	n
emotive	j
dismantling	n
tested	j
rooted	j
concealment	n
preconceived	j
laudable	j
imprecise	j
permeable	j
catalyze	v
append	v
successively	r
unattainable	j
peer-reviewed	j
onwards	r
inadvertent	j
manifold	j
proportionally	r
receptivity	n
cross-national	j
proscribe	v
profitably	r
moralistic	j
de-emphasize	v
dispensation	n
self-sacrifice	n
recovered	j
requisite	n
urbanized	j
expediency	n
exclusivity	n
germane	j
self-help	n
linking	n
nebulous	j
appreciably	r
laborious	j
inhospitable	j
rethinking	n
unanimity	n
pervasiveness	n
archeological	j
skewed	j
add-on	j
near-term	j
methodologically	r
irreconcilable	j
impute	v
energetically	r
enumeration	n
culpability	n
customarily	r
expedient	j
complicating	j
inimical	j
salaried	j
weighing	n
well-organized	j
rejected	j
nested	j
mediated	j
irrelevance	n
modus	n
postulate	n
firstly	r
reorder	v
upsurge	n
ritualized	j
ubiquity	n
disentangle	v
non-competitive	j
predetermine	v
idiosyncrasy	n
fortuitous	j
summarily	r
unexamined	j
uncritically	r
testable	j
functionary	n
permeability	n
needed	j
discontinuous	j
destabilization	n
city-state	n
singly	r
regenerative	j
vicissitude	n
unjustified	j
paleolithic	j
enmesh	v
second-order	j
succinct	j
funder	n
irrationality	n
meaningfulness	n
disorganization	n
bylaw	n
blurring	n
demonstrable	j
enquiry	n
enabling	j
neurosis	n
opacity	n
industrialize	v
demographically	r
unconnected	j
truism	n
undefined	j
discredited	j
disenchantment	n
male-female	j
hierarchically	r
reconfiguration	n
globalize	v
incrementally	r
interdependency	n
ostensible	j
edited	j
apathetic	j
tabulation	n
conjecture	v
constrained	j
duplicate	j
institutionally	r
incapacity	n
gender-specific	j
truncated	j
venerate	v
impartiality	n
disallow	v
demonstrably	r
derived	j
all-encompassing	j
originator	n
positivist	j
panoply	n
betterment	n
diametrically	r
disproportionately	r
unknowable	j
self-defeating	j
constancy	n
identifying	j
maximization	n
inequitable	j
ingrained	j
broadening	n
decentralize	v
first-order	j
stabilizing	j
sufficiency	n
supported	j
sending	n
unrealized	j
cogent	j
autonomously	r
corrected	j
ineffectiveness	n
vagueness	n
reconstructed	j
prejudicial	j
amalgamation	n
unacknowledged	j
unidimensional	j
unsound	j
representativeness	n
extractive	j
add-on	n
sponsoring	j
remuneration	n
professed	j
prefix	n
contextually	r
refutation	n
transference	n
traceable	j
unsupported	j
biweekly	r
excluded	j
preset	j
fourfold	j
normalized	j
dovetail	v
timeliness	n
reformulation	n
contained	j
capitulation	n
equitably	r
multilingual	j
legalistic	j
reactivate	v
disrupted	j
conflictual	j
annotate	v
aberrant	j
class	v
two-stage	j
yielding	j
undermining	n
subservient	j
affirmatively	r
prohibitively	r
card	v
converse	n
soundness	n
two-step	j
egocentric	j
oversimplification	n
participative	j
dissimilarity	n
aver	v
self-preservation	n
expropriate	v
propound	v
long-established	j
husbandry	n
monopolistic	j
comparably	r
sterility	n
requested	j
unimpeded	j
ferment	n
parsimonious	j
principality	n
rapidity	n
homogenization	n
gradation	n
imperfectly	r
irregularly	r
reintegrate	v
threefold	r
underestimation	n
recoverable	j
rearrangement	n
poignantly	r
centered	j
injurious	j
changeable	j
concomitantly	r
bifurcation	n
abbreviate	v
self-selected	j
universal	n
incorporated	j
readjustment	n
conditional	n
disassociate	v
unhelpful	j
unsurprisingly	r
fine-grained	j
prompting	n
military-industrial	j
post-industrial	j
pragmatically	r
disequilibrium	n
unavoidably	r
militate	v
multilayered	j
metallurgy	n
inverse	n
uncontested	j
reestablishment	n
secondarily	r
vexing	j
misalignment	n
existent	j
cause-and-effect	j
entangled	j
programmed	j
impure	j
disposed	j
relativist	n
reinterpret	v
systematize	v
xenophobic	j
market-driven	j
arc	v
converging	j
militaristic	j
modelling	n
intermingle	v
isolating	j
copying	n
falsity	n
searchable	j
self-improvement	n
embedding	n
reaffirmation	n
reappraisal	n
propitious	j
depredation	n
denigration	n
arguable	j
proliferating	j
functionalist	n
separable	j
rejoinder	n
upper-level	j
unstated	j
high-value	j
interpolation	n
bibliographic	j
differentiating	j
abortive	j
anatomically	r
maximally	r
proscription	n
patent	j
purchased	j
non-professional	j
unidirectional	j
redirection	n
reversion	n
obtainable	j
privation	n
inborn	j
bimonthly	r
capitalistic	j
circumscribed	j
targeting	n
unusable	j
unpalatable	j
causally	r
prioritization	n
overemphasis	n
imprimatur	n
coherently	r
component	j
tangential	j
relevancy	n